XXXXXXXXXXXXXXXXXXXXXXXXXXXXXXXXXXXXXXXXXXXXXXXXXXXXXXXXXXXXXXXXXXXXXX
X                                                                    X
X                                                                    X
X                                                                    X
X                                                                    X
X                                                                    X
X                                                                    X
X                                                                    X
X                                                                    X
X                                                                    X
X                                                                    X
X                                                                    X
X                                                                    X
X                                       X                            X
X                                                                    X
X                       X       X                                    X
X                                                                    X
X                X                                                   X
X                                                                    X
X                                                                    X
X           X                                                        X
X                                                                    X
X                                                                    X
X                  X                                                 X
X                                                                    X
X                        X                                           X
X                                                                    X
X                                                                    X
X                                                                    X
XXXXXXXXXXXXXXXXXXXXXXXXXXXXXXXXXXXXXXXXXXXXXXXXXXXXXXXXXXXXXXXXXXXXXX
